NO ./texture/wall1.xpm42
WE ./texture/wall2.xpm42
EA ./texture/wall3.xpm42
SO ./texture/wall4.xpm42

F 80,80,80
C 30,30,30

111111111111111111111
1E0000100000100000001
101110101110101111101
101000100010001010001
101111111011101010111
100010001000100010101
111010111010111110101
100000100010001000001
101111101011111011111
100000001000100000001
111111111111111111111
