NO ./texture/wall1.xpm42
WE ./texture/wall2.xpm42
EA ./texture/wall3.xpm42
SO ./texture/wall4.xpm42

F 80,80,80
C 30,30,30

1111111111111111111111111
1000000000110000000000001
1011000001110000000000001
100100000000000000000000111111111
111111111011000001110000000000001
100000000011000001110111111111111
11110111111111011100000010001
11110111111111011101010000001
11000000110101011100000010001
10000000000000001100000010001
1000000E000000001101010010001
11000001110101011111011110001
11110111 1110101 101111010001
11111111 1111111 111111111111
