NO ./texture/vr.xpm42
WE ./texture/Blue.xpm42
EA ./texture/Green.xpm42
SO ./texture/Grey.xpm42

F 200,200,200
C 0,0,0

11111111111111111111111111
10000000000000000000000001
10000000000000000000000001
10000000000000000000000001
10000000000011111111111111
10000000000011111111111111
10000000000000000000000001
100E0000000000000000000001
10000000000000000000000001
10000000000011111111111101
10000000000011111111111111
10000000000000000000000001
10000000000000000000000001
10000000000000000000000001
11111111111111111111111111
