NO ./texture/greencs.xpm42
WE ./texture/cs.xpm42
EA ./texture/blackcs.xpm42
SO ./texture/bluecs.xpm42

F 66,42,50
C 36,86,145

1111111111111111111
1000000000000000001
10N0000000000000001
1000000000000000001
1111111111111111111
