NO ./texture/vr.xpm42
WE ./texture/Blue.xpm42
EA ./texture/Green.xpm42
SO ./texture/Grey.xpm42

F 225,206,154
C 210,210,210


11111111111111111111111111111
10000000011000000000000011111
10110000011100000000000011111
1111111100000000000N000000111
11011111010000011100000000001
10000000011100000111011111111
11110111111111011100000010001
11110111111111011101010010001
11000000110101011100000010001
1000E000000000011000000010001
10000000100000001101010001001
11000000001010111000111110011
11110111110000011011110000011
11111111111111111111111111111
