NO ./texture/vr.xpm42
WE ./texture/Blue.xpm42
EA ./texture/Green.xpm42
SO ./texture/Grey.xpm42

F 195,51,29
C 200,170,190


1111111111111111111111111
1100000001100000000000001
101100000111000000000000111
11111111000000000000000000111111
11011111010000011100000000000001
100000000011000001110111111111111
11110111111111011100000010001
11110111111111011101010010001
11000000110101011100000010001
10000000000000011000000010001
100E0000100000001101010001001
11000000001010111110111110111
1111011111000001101111011011
111111111111111111111111111
